################################
#  A       ###########     #####
#          ##                  #
#  ##      ## ###   ##         #
#  ####    ##  ##      ######  #
#####     ######   ##  ####    #
###       #####      ### ##  ###
#       #########    ##  ### ###
#                        ##  B #
###       ###  ###  ######     #
#######################        #
################################